{
  "0": 3,
  "1": 4,
  "2": 11,
  "3": 13,
  "4": 14,
  "5": 15,
  "6": 17,
  "7": 19,
  "8": 20,
  "9": 22,
  "10": 34
}